
C 100,255,12
F 100,45,120

NO maps/path_to_the_north_texture
SO maps/path_to_the_south_texture
WE maps/path_to_the_west_texture
EA maps/path_to_the_east_texture


11111111111111111
10000000000000111
10000000000E00011
11111111111111111
