
C 255,255,255
F 100,45,120

NO maps/path_to_the_north_texture.png
SO maps/path_to_the_south_texture.png
WE maps/path_to_the_west_texture.png
EA maps/path_to_the_east_texture.png


111111111111111111111111111111111111
100001000000000000000000000000000001
100001000000000000000000000000000001
1111010000000W0000000000000000000001
100000000000000000000000000000000001
111101001000000000000000000000000001
100001001000000000000000000000000001
100001001000000000000000000000000001
100001001111111111111111111111111101
100001000000000000000000000000000001
111111111111111111111111111111111111
