
C 0,100,255
F 255,100,0

NO srcs/textures/mouton.png
SO srcs/textures/bobby.png
WE srcs/textures/cow.png
EA srcs/textures/nothing_here.png

1111111
10000N1
1111111
