
C 255,255,255
F 100,45,12

NO srcs/textures/mouton.png
SO srcs/textures/bobby.png
WE srcs/textures/cow.png
EA srcs/textures/nothing_here.png


111111111111111111111111111111111111
100001000000000000000000000000000001
100001000001110000000000000000000001
111101000000000000000000000000000001
1000000000000N0000000000000000000001
111101001000000000000000000000000001
100001001000000000000000000000000001
100001001000000000000000000000000001
100001001111111111111111111111111101
100001000000000000000000000000000001
111111111111111111111111111111111111
