
C 27,25,25
F 90,74,21

NO srcs/textures/pipe.png
SO srcs/textures/brick.png
WE srcs/textures/crate.png
EA srcs/textures/grid.png

1111111111111
1001000010001
1001000010001
11000S0000111
1001000010001
1001000010001
1111111111111