
C 255,255,255
F 100,45,120

NO srcs/textures/mouton.png
SO srcs/textures/bobby.png
WE srcs/textures/cow.png
EA srcs/textures/nothing_here.png


1111111
1000001
100N001
1000001
1111111