NO srcs/textures/mouton.png
SO srcs/textures/bobby.png
WE srcs/textures/cow.png
EA srcs/textures/nothing_here.png

F 220,100,0
C 225,8     ,66

111111111
100000001
1011N1101
100000001
111111111
